19 19
1 1

WWWWWWWWWWWWWWWWWWW
WPWPPPPPPPPPPPPPPPW
WPWPWWWPWPWWWWWWWWW
WPPPWPPPWPPPPPPPPPW
WPWWWPWWWWWWWWWPWPW
WPWPPPWPPPPPPPWPWPW
WPWWWWWPWWWWWPWWWPW
WPPPWPPPPPPPWPWPPPW
WWWPWPWWWWWPWPWPWPW
WPPPWPWPPPWPWPWPWPW
WWWPWPWPWPWPWPWPWPW
WPPPWPPPWPWPWPPPWPW
WPWWWWWWWPWWWWWWWWW
WPPPPPPPWPWPPPPPPPW
WWWWWPWPWPWPWWWWWPW
WPPPWPWPWPPPWPPPWPW
WPWWWPWPWWWWWPWPWPW
WPPPPPWPPPPPPPWPWEW
WWWWWWWWWWWWWWWWWWW
